************
*   BBBB   *
*   BBBBB  *
*          *
*        ***
*          *
***        *
*          *
*  AAAAA   *
*   AAAA   *
************