************
*    BBB   * 
*          *
*          *
*          *
*          *
*          *
*          *
*          *
*    AAA   *
************