**************
*  AAAAA     *
*            *
*            *
*            *
*       ******
*            *
*            *
******       *
*            *
*            *
*            *
*            *
*     BBBBB  *
**************