************
*          *
*   B B    *
* B        *
*        B *
*          *
*          *
*     A    *
*  A AAA   *
*          *
*          *
************