***************************************
*   *                       B         *
*    *     *             BBBBBBB      *
*    *     *                          *
*          *                          *
*          *****                      *
*          *           **       *******
*     A    *           **       *
*    AAA   *            *       *
*    AAA   *           **       *
*          *            *       *
*********************************