***************************************
*   *                                 *
*    *     *                          *
*    *     *                          *
*          *                          *
*          *****                      *
*          *           **       *******
*          *           **       *
*          *            *       *
*          *           **       *
*          *            *       *
*********************************